16 16 8
1 2 6 4 6 2 1 1 1 8 5 6 5 5 5 6 
5 4 4 5 6 1 6 8 3 7 2 7 4 2 1 4 
4 6 8 1 7 8 1 8 7 5 5 4 2 1 1 6 
4 4 3 2 5 8 1 7 6 3 5 1 4 5 5 7 
2 4 8 8 3 8 7 2 5 3 5 6 3 5 3 7 
1 5 8 5 4 8 3 2 2 7 2 6 3 6 4 4 
1 3 3 4 3 2 5 7 4 1 4 7 5 6 5 5 
3 4 1 6 3 3 7 5 1 1 2 3 6 5 6 7 
8 1 2 2 2 6 8 5 6 3 3 2 8 7 7 2 
2 7 8 5 2 6 1 2 6 2 5 4 6 2 2 5 
2 3 6 3 8 5 8 5 7 2 6 7 1 4 8 2 
3 7 6 4 5 6 5 2 7 1 5 5 3 6 1 4 
8 7 7 7 3 6 3 2 7 1 8 7 4 7 1 6 
6 6 1 2 4 6 3 2 6 8 6 8 5 7 4 5 
5 2 3 7 7 6 8 5 6 7 4 1 6 4 7 3 
1 7 4 4 4 6 6 2 5 3 1 2 1 4 6 5 
